"a" = (/turf/wall,/area)
"b" = (/turf/ground,/area)
"c" = (/mob/goai/agent{icon = 'icons/uristmob/scommobs.dmi'; icon_state = "civ3"; name = "Jim"},/turf/ground,/area)
"d" = (/obj/food,/turf/ground,/area)
"e" = (/obj/desk,/turf/ground,/area)
"f" = (/obj/vending,/turf/ground,/area)
"g" = (/obj/bed,/turf/ground,/area)
"h" = (/mob/goai/agent{icon = 'icons/uristmob/scommobs.dmi'; icon_state = "civ10"; name = "Bob"},/turf/ground,/area)

(1,1,1) = {"
aaaaaaaaaaaaaaaaaaaaaaaaaaaaaaaa
abbbbbbbbbbbbbbbbbbbbbbbbbbbbbba
abbbbbbbbbbbbbbbbbbbbbbbbbbbbbba
abbbbbbbbbbbbbbbbbbbbbbbbbbbbbba
abbbbbbbbbbbbbbbbbbbbbbbbbbbbbba
abbbbbbbbbbbbbfbbbbbbbbbbbbbbbba
abbbbbbbbbbbbbbbbbbbbbgbbbbbbbba
abbbbbbbbbbbbbbbbbbbbbbbbbbbbbba
abbbbbbbbbbbbbbbbbbbbbbbbbbbbbba
abbbbbbbbbbbbbbbbbbbbbbbbbbbbbba
abbbbbbbbbbbbbbbbbbbbbbbbbbbbbba
abbbbbbbbbbbbbbbbbbbbbbebbbbbbba
abbbbbbbbbbbbbbbbbbbbbbbbbbbbbba
abbbbbbbbbbbbbbbbbbbbbbbbbbbbbba
abbbbbbbbbbbbbbbbbbbbbbbbbbbbbba
abbbbbbbbbcbbbbbbddbbbbbbbbbbbba
abbbbbbbbbbbbbbbbbbbbbbbbbbbbbba
abbbbbbbbbbbbbbbbbbbbbbbbbbbbbba
abbbbbbbbbbbbbbbbbbbbbbbbbbbbbba
abbbbbbbgbbbbbbbbbbbbbbbbbbbbbba
abbbbbbbbbbbbbbbbbbbbbbbbhbbbbba
abbbbbbbbbbbbbbbbbbbbbbbbbbbbbba
abbbbbbbbbbbbbbbbbbbbbbbbbbbbbba
abbbbbbbbbbbbbbbbbbbbbbbbbbbbbba
abbbbbbbbbbbbbbbbbbbbbbbbbbbbbba
abbbbbbbbbbbbbbebbbbbbbbbbbbbbba
abbbbbbbbbbbbbbbbbbbbbbbbbbbbbba
abbbbbbbbbbbbbbbbbbbbbbbbbbbbbba
abbbbbbbbbbbbbbbbbbbbbbbbbbbbbba
abbbbbbbbbbbbbbbbbbbbbbbbbbbbbba
abbbbbbbbbbbbbbbbbbbbbbbbbbbbbba
aaaaaaaaaaaaaaaaaaaaaaaaaaaaaaaa
"}
