"a" = (/turf/wall,/area)
"b" = (/turf/ground,/area)
"c" = (/mob/goai/combatant,/turf/ground,/area)
"d" = (/mob/goai/combatant{name = "combatant 2"},/turf/ground,/area)

(1,1,1) = {"
aaaaaaaaaaaaaaaaaaaaaaaaaaaaaaaa
abbababaabbaaabbaabbbabbbaabbbaa
abaabababbbbabbbbabbbabbaabbbbba
abbbbbbbbbbbbbbbbbbbbabbbbbbbbba
abbbbbbabbbbabbbbabbbabbbabbbbba
aaaabaaaabbaaabbaaabaaaaaaaabaaa
abbababbaaaaaaaaaabbbbbbbbabbbba
abbbbbbbbbbabbbbbbbbbbbbbbabbbba
abbababbaababbbbbabbbbbbbbaaabaa
aaaabaaaaababbbbaaaaabbbbbbabbba
abbababbbababaaaababaaaaaaaabbba
abbababbbababbbbbbbbbbbbbabbbbba
abbababbbbbbbbbbbbbbbbbbbbbbbbba
abbbbabbbababbbbbbbbbbbbbabbbbba
abbabaabaaaaaaaaaabaaaaaaaaaaaaa
abbabbbbbbbbbbbbbabbabbabbbbabba
aababbbbbbbbbbdbaabbabbabbbbabba
abbabbbbbbbbbbbbabbaabaaabbaabba
abbaaabbbbabbbaaaabbabbabbbbaaba
abbabbbbbbbbbbbbabbaabbabbbbabba
abbabbbbcbbbbbbbaabbabbabbbbabaa
abbabbbbbbbbbbbbabbaabbbbbbbbbba
abbaaabbbbbbbbaaabbbabbbbbbbbbba
abbabbbbbbbbbbbbaabaabbbbbbbbbba
abaabbbbbbbbbbbbabbbabbbbbbbbbba
abbabbbbbbbbbbbaabbbbbbbbbbbbbba
abbaaabbbbabbbbbbbbbabbbbbbbbbba
abbabbbbbbbbbbbaaabaaabaaaabaaaa
abbaaabbbbbbbbbbabbbabbbbbbbbbba
abbbbbbbbbbbbbbbbbbbbbbbbbbbbbba
abbaaabbbbbbbbbbabbbabbbbbbbbbba
aaaaaaaaaaaaaaaaaaaaaaaaaaaaaaaa
"}
