"a" = (/turf/wall,/area)
"b" = (/turf/ground,/area)
"c" = (/mob/living/simple_animal/aitester/utility{name = "Alpha"; spawn_commander = 1},/turf/ground,/area)
"d" = (/obj/cover/autodoor{start_bolted = 1; start_welded = 0; tag = "test_autodoor"},/turf/ground,/area)
"e" = (/obj/item/up_test_multitool{tag = "test_multitool"},/turf/ground,/area)
"f" = (/obj/item/up_test_screwdriver{tag = "test_screwdriver"},/turf/ground,/area)
"g" = (/obj/item/up_test_welder{tag = "test_welder"},/turf/ground,/area)
"h" = (/obj/cover/autodoor{start_bolted = 1; start_welded = 1; tag = "test_autodoor3"},/turf/ground,/area)
"i" = (/obj/cover/autodoor{start_bolted = 1; start_welded = 1; tag = "test_autodoor2"},/turf/ground,/area)
"j" = (/obj/cover/autodoor{start_bolted = 1; start_welded = 0; tag = "test_autodoor4"},/turf/ground,/area)

(1,1,1) = {"
aaaaaabb
abbjbaab
adaabbab
abbaahab
aebbibaa
afbbabba
agbcaaba
aaaaaaaa
"}
