"a" = (/turf/wall,/area)
"b" = (/turf/ground,/area)
"c" = (/mob/living/simple_animal/aitester/utility{faction = "ANTAG"; name = "ANTAG D"; real_name = "ANTAG D"},/turf/ground,/area)
"d" = (/mob/living/simple_animal/aitester/utility{faction = "B"; icon_state = "terran_marine"; name = "Terran B"; real_name = "Terran B"},/turf/ground,/area)
"e" = (/mob/living/simple_animal/aitester/utility{faction = "ANTAG"; name = "ANTAG C"; real_name = "ANTAG C"},/turf/ground,/area)
"f" = (/obj/cover/barricade,/turf/ground,/area)
"g" = (/mob/living/simple_animal/aitester/utility{faction = "ANTAG"; name = "ANTAG E"; real_name = "ANTAG E"},/turf/ground,/area)
"h" = (/obj/goai_spawner/oneshot/table_flipped/west,/turf/ground,/area)
"i" = (/obj/goai_spawner/oneshot/table_flipped/south,/turf/ground,/area)
"j" = (/obj/goai_spawner/oneshot/table_flipped/north,/turf/ground,/area)
"k" = (/mob/living/simple_animal/aitester/utility{faction = "B"; icon_state = "terran_marine"; name = "Terran A"; real_name = "Terran A"},/turf/ground,/area)
"l" = (/mob/living/simple_animal/aitester/utility{faction = "B"; icon_state = "terran_marine"; name = "Terran D"; real_name = "Terran D"},/turf/ground,/area)
"m" = (/mob/living/simple_animal/aitester/utility{faction = "B"; icon_state = "terran_marine"; name = "Terran C"; real_name = "Terran C"},/turf/ground,/area)
"n" = (/mob/living/simple_animal/aitester/utility{faction = "ANTAG"; name = "ANTAG B"; real_name = "ANTAG B"},/turf/ground,/area)
"o" = (/mob/living/simple_animal/aitester/utility{faction = "ANTAG"; name = "ANTAG A"; real_name = "ANTAG A"},/turf/ground,/area)
"p" = (/mob/living/simple_animal/aitester/utility{faction = "Skrell"; icon_state = "skrellorist"; name = "Skrellorist A"; real_name = "Skrellorist A"},/turf/ground,/area)
"q" = (/mob/living/simple_animal/aitester/utility{faction = "Skrell"; icon_state = "skrellorist"; name = "Skrellorist C"; real_name = "Skrellorist C"},/turf/ground,/area)
"r" = (/mob/living/simple_animal/aitester/utility{faction = "Skrell"; icon_state = "skrellorist"; name = "Skrellorist B"; real_name = "Skrellorist B"},/turf/ground,/area)
"s" = (/mob/living/simple_animal/aitester/utility{faction = "Skrell"; icon_state = "skrellorist"; name = "Skrellorist D"; real_name = "Skrellorist D"},/turf/ground,/area)
"t" = (/obj/goai_spawner/oneshot/table_flipped/east,/mob/living/simple_animal/aitester/utility{faction = "Skrell"; icon_state = "skrellorist"; name = "Skrellorist E"; real_name = "Skrellorist E"},/turf/ground,/area)
"u" = (/obj/goai_spawner/oneshot/table_flipped/west,/mob/living/simple_animal/aitester/utility{faction = "B"; icon_state = "terran_marine"; name = "Terran E"; real_name = "Terran E"},/turf/ground,/area)
"v" = (/obj/goai_spawner/oneshot/table_flipped/south,/mob/living/simple_animal/aitester/utility{faction = "B"; icon_state = "terran_marine"; name = "Terran E"; real_name = "Terran E"},/turf/ground,/area)
"w" = (/obj/goai_spawner/oneshot/table_flipped/south,/mob/living/simple_animal/aitester/utility{faction = "ANTAG"; name = "ANTAG E"; real_name = "ANTAG E"},/turf/ground,/area)
"x" = (/mob/living/simple_animal/aitester/utility{faction = "Skrell"; icon_state = "skrellorist"; name = "Skrellorist E"; real_name = "Skrellorist E"},/turf/ground,/area)
"y" = (/mob/living/simple_animal/aitester/utility{faction = "B"; icon_state = "terran_marine"; name = "Terran E"; real_name = "Terran E"},/turf/ground,/area)
"z" = (/obj/goai_spawner/oneshot/table_flipped/west,/mob/living/simple_animal/aitester/utility{faction = "Skrell"; icon_state = "skrellorist"; name = "Skrellorist E"; real_name = "Skrellorist E"},/turf/ground,/area)
"A" = (/obj/goai_spawner/oneshot/table_flipped/north,/mob/living/simple_animal/aitester/utility{faction = "B"; icon_state = "terran_marine"; name = "Terran E"; real_name = "Terran E"},/turf/ground,/area)
"B" = (/obj/goai_spawner/oneshot/table_flipped/north,/mob/living/simple_animal/aitester/utility{faction = "Skrell"; icon_state = "skrellorist"; name = "Skrellorist E"; real_name = "Skrellorist E"},/turf/ground,/area)
"C" = (/obj/goai_spawner/oneshot/table_flipped/east,/mob/living/simple_animal/aitester/utility{faction = "ANTAG"; name = "ANTAG E"; real_name = "ANTAG E"},/turf/ground,/area)
"D" = (/obj/goai_spawner/oneshot/table_flipped/north,/mob/living/simple_animal/aitester/utility{faction = "ANTAG"; name = "ANTAG E"; real_name = "ANTAG E"},/turf/ground,/area)

(1,1,1) = {"
abbaaaaaaaaaaaaaaa
abbababbbbgabbbbba
aababtbbibbbbbubba
abbabbbbcbbabbhbba
abbavibbbbvaabbbaa
abbabbbebnbagbbwba
abbabbbbobaafdbbba
abbaygbbbbakbbblja
abbaaaaabaabbmbbba
abbaxbaxbbbwxbaaaa
abaabybbbpbbbbghya
abbabbbqbbbrbbbzba
abbaAjbbbsbbbbbbba
abbabbbbbbfjBbabAa
aaaabCbbbbgbbbabba
aybhbbbDbaabaaabba
abbbxabbbxabgbagba
aaaaaaaaaaaaaaaaaa
"}
