"a" = (/turf/deepmaint_wall/border,/area/deepmaint)
"b" = (/turf/procgen/wfc,/area/deepmaint)
"c" = (/turf/deepmaint_wall/border,/area)
"d" = (/turf/procgen/wfc,/area)

(1,1,1) = {"
aaaaaaaaaaaaaaaaaaaaaaaaaaaaaaaaaaaaaaaaaaaaaaaaaaaaaaaaaaaaaaaaaaaaaaaaaaaaaaaaaaaaaaaaaa
abbbbbbbbbbbbbbbbbbbbbbbbbbbbbbbbbbbbbbbbbbbbbbbbbbbbbbbbbbbbbbbbbbbbbbbbbbbbbbbbbbbbbbbba
abbbbbbbbbbbbbbbbbbbbbbbbbbbbbbbbbbbbbbbbbbbbbbbbbbbbbbbbbbbbbbbbbbbbbbbbbbbbbbbbbbbbbbbba
abbbbbbbbbbbbbbbbbbbbbbbbbbbbbbbbbbbbbbbbbbbbbbbbbbbbbbbbbbbbbbbbbbbbbbbbbbbbbbbbbbbbbbbba
abbbbbbbbbbbbbbbbbbbbbbbbbbbbbbbbbbbbbbbbbbbbbbbbbbbbbbbbbbbbbbbbbbbbbbbbbbbbbbbbbbbbbbbba
abbbbbbbbbbbbbbbbbbbbbbbbbbbbbbbbbbbbbbbbbbbbbbbbbbbbbbbbbbbbbbbbbbbbbbbbbbbbbbbbbbbbbbbba
abbbbbbbbbbbbbbbbbbbbbbbbbbbbbbbbbbbbbbbbbbbbbbbbbbbbbbbbbbbbbbbbbbbbbbbbbbbbbbbbbbbbbbbba
abbbbbbbbbbbbbbbbbbbbbbbbbbbbbbbbbbbbbbbbbbbbbbbbbbbbbbbbbbbbbbbbbbbbbbbbbbbbbbbbbbbbbbbba
abbbbbbbbbbbbbbbbbbbbbbbbbbbbbbbbbbbbbbbbbbbbbbbbbbbbbbbbbbbbbbbbbbbbbbbbbbbbbbbbbbbbbbbba
abbbbbbbbbbbbbbbbbbbbbbbbbbbbbbbbbbbbbbbbbbbbbbbbbbbbbbbbbbbbbbbbbbbbbbbbbbbbbbbbbbbbbbbba
abbbbbbbbbbbbbbbbbbbbbbbbbbbbbbbbbbbbbbbbbbbbbbbbbbbbbbbbbbbbbbbbbbbbbbbbbbbbbbbbbbbbbbbba
abbbbbbbbbbbbbbbbbbbbbbbbbbbbbbbbbbbbbbbbbbbbbbbbbbbbbbbbbbbbbbbbbbbbbbbbbbbbbbbbbbbbbbbba
abbbbbbbbbbbbbbbbbbbbbbbbbbbbbbbbbbbbbbbbbbbbbbbbbbbbbbbbbbbbbbbbbbbbbbbbbbbbbbbbbbbbbbbba
abbbbbbbbbbbbbbbbbbbbbbbbbbbbbbbbbbbbbbbbbbbbbbbbbbbbbbbbbbbbbbbbbbbbbbbbbbbbbbbbbbbbbbbba
abbbbbbbbbbbbbbbbbbbbbbbbbbbbbbbbbbbbbbbbbbbbbbbbbbbbbbbbbbbbbbbbbbbbbbbbbbbbbbbbbbbbbbbba
abbbbbbbbbbbbbbbbbbbbbbbbbbbbbbbbbbbbbbbbbbbbbbbbbbbbbbbbbbbbbbbbbbbbbbbbbbbbbbbbbbbbbbbba
abbbbbbbbbbbbbbbbbbbbbbbbbbbbbbbbbbbbbbbbbbbbbbbbbbbbbbbbbbbbbbbbbbbbbbbbbbbbbbbbbbbbbbbba
abbbbbbbbbbbbbbbbbbbbbbbbbbbbbbbbbbbbbbbbbbbbbbbbbbbbbbbbbbbbbbbbbbbbbbbbbbbbbbbbbbbbbbbba
abbbbbbbbbbbbbbbbbbbbbbbbbbbbbbbbbbbbbbbbbbbbbbbbbbbbbbbbbbbbbbbbbbbbbbbbbbbbbbbbbbbbbbbba
abbbbbbbbbbbbbbbbbbbbbbbbbbbbbbbbbbbbbbbbbbbbbbbbbbbbbbbbbbbbbbbbbbbbbbbbbbbbbbbbbbbbbbbba
abbbbbbbbbbbbbbbbbbbbbbbbbbbbbbbbbbbbbbbbbbbbbbbbbbbbbbbbbbbbbbbbbbbbbbbbbbbbbbbbbbbbbbbba
abbbbbbbbbbbbbbbbbbbbbbbbbbbbbbbbbbbbbbbbbbbbbbbbbbbbbbbbbbbbbbbbbbbbbbbbbbbbbbbbbbbbbbbba
abbbbbbbbbbbbbbbbbbbbbbbbbbbbbbbbbbbbbbbbbbbbbbbbbbbbbbbbbbbbbbbbbbbbbbbbbbbbbbbbbbbbbbbba
abbbbbbbbbbbbbbbbbbbbbbbbbbbbbbbbbbbbbbbbbbbbbbbbbbbbbbbbbbbbbbbbbbbbbbbbbbbbbbbbbbbbbbbba
abbbbbbbbbbbbbbbbbbbbbbbbbbbbbbbbbbbbbbbbbbbbbbbbbbbbbbbbbbbbbbbbbbbbbbbbbbbbbbbbbbbbbbbba
abbbbbbbbbbbbbbbbbbbbbbbbbbbbbbbbbbbbbbbbbbbbbbbbbbbbbbbbbbbbbbbbbbbbbbbbbbbbbbbbbbbbbbbba
abbbbbbbbbbbbbbbbbbbbbbbbbbbbbbbbbbbbbbbbbbbbbbbbbbbbbbbbbbbbbbbbbbbbbbbbbbbbbbbbbbbbbbbba
abbbbbbbbbbbbbbbbbbbbbbbbbbbbbbbbbbbbbbbbbbbbbbbbbbbbbbbbbbbbbbbbbbbbbbbbbbbbbbbbbbbbbbbba
abbbbbbbbbbbbbbbbbbbbbbbbbbbbbbbbbbbbbbbbbbbbbbbbbbbbbbbbbbbbbbbbbbbbbbbbbbbbbbbbbbbbbbbba
abbbbbbbbbbbbbbbbbbbbbbbbbbbbbbbbbbbbbbbbbbbbbbbbbbbbbbbbbbbbbbbbbbbbbbbbbbbbbbbbbbbbbbbba
abbbbbbbbbbbbbbbbbbbbbbbbbbbbbbbbbbbbbbbbbbbbbbbbbbbbbbbbbbbbbbbbbbbbbbbbbbbbbbbbbbbbbbbba
abbbbbbbbbbbbbbbbbbbbbbbbbbbbbbbbbbbbbbbbbbbbbbbbbbbbbbbbbbbbbbbbbbbbbbbbbbbbbbbbbbbbbbbba
abbbbbbbbbbbbbbbbbbbbbbbbbbbbbbbbbbbbbbbbbbbbbbbbbbbbbbbbbbbbbbbbbbbbbbbbbbbbbbbbbbbbbbbba
abbbbbbbbbbbbbbbbbbbbbbbbbbbbbbbbbbbbbbbbbbbbbbbbbbbbbbbbbbbbbbbbbbbbbbbbbbbbbbbbbbbbbbbba
abbbbbbbbbbbbbbbbbbbbbbbbbbbbbbbbbbbbbbbbbbbbbbbbbbbbbbbbbbbbbbbbbbbbbbbbbbbbbbbbbbbbbbbba
abbbbbbbbbbbbbbbbbbbbbbbbbbbbbbbbbbbbbbbbbbbbbbbbbbbbbbbbbbbbbbbbbbbbbbbbbbbbbbbbbbbbbbbba
abbbbbbbbbbbbbbbbbbbbbbbbbbbbbbbbbbbbbbbbbbbbbbbbbbbbbbbbbbbbbbbbbbbbbbbbbbbbbbbbbbbbbbbba
abbbbbbbbbbbbbbbbbbbbbbbbbbbbbbbbbbbbbbbbbbbbbbbbbbbbbbbbbbbbbbbbbbbbbbbbbbbbbbbbbbbbbbbba
abbbbbbbbbbbbbbbbbbbbbbbbbbbbbbbbbbbbbbbbbbbbbbbbbbbbbbbbbbbbbbbbbbbbbbbbbbbbbbbbbbbbbbbba
abbbbbbbbbbbbbbbbbbbbbbbbbbbbbbbbbbbbbbbbbbbbbbbbbbbbbbbbbbbbbbbbbbbbbbbbbbbbbbbbbbbbbbbba
abbbbbbbbbbbbbbbbbbbbbbbbbbbbbbbbbbbbbbbbbbbbbbbbbbbbbbbbbbbbbbbbbbbbbbbbbbbbbbbbbbbbbbbba
abbbbbbbbbbbbbbbbbbbbbbbbbbbbbbbbbbbbbbbbbbbbbbbbbbbbbbbbbbbbbbbbbbbbbbbbbbbbbbbbbbbbbbbba
abbbbbbbbbbbbbbbbbbbbbbbbbbbbbbbbbbbbbbbbbbbbbbbbbbbbbbbbbbbbbbbbbbbbbbbbbbbbbbbbbbbbbbbba
abbbbbbbbbbbbbbbbbbbbbbbbbbbbbbbbbbbbbbbbbbbbbbbbbbbbbbbbbbbbbbbbbbbbbbbbbbbbbbbbbbbbbbbba
abbbbbbbbbbbbbbbbbbbbbbbbbbbbbbbbbbbbbbbbbbbbbbbbbbbbbbbbbbbbbbbbbbbbbbbbbbbbbbbbbbbbbbbba
abbbbbbbbbbbbbbbbbbbbbbbbbbbbbbbbbbbbbbbbbbbbbbbbbbbbbbbbbbbbbbbbbbbbbbbbbbbbbbbbbbbbbbbba
abbbbbbbbbbbbbbbbbbbbbbbbbbbbbbbbbbbbbbbbbbbbbbbbbbbbbbbbbbbbbbbbbbbbbbbbbbbbbbbbbbbbbbbba
abbbbbbbbbbbbbbbbbbbbbbbbbbbbbbbbbbbbbbbbbbbbbbbbbbbbbbbbbbbbbbbbbbbbbbbbbbbbbbbbbbbbbbbba
abbbbbbbbbbbbbbbbbbbbbbbbbbbbbbbbbbbbbbbbbbbbbbbbbbbbbbbbbbbbbbbbbbbbbbbbbbbbbbbbbbbbbbbba
abbbbbbbbbbbbbbbbbbbbbbbbbbbbbbbbbbbbbbbbbbbbbbbbbbbbbbbbbbbbbbbbbbbbbbbbbbbbbbbbbbbbbbbba
abbbbbbbbbbbbbbbbbbbbbbbbbbbbbbbbbbbbbbbbbbbbbbbbbbbbbbbbbbbbbbbbbbbbbbbbbbbbbbbbbbbbbbbba
abbbbbbbbbbbbbbbbbbbbbbbbbbbbbbbbbbbbbbbbbbbbbbbbbbbbbbbbbbbbbbbbbbbbbbbbbbbbbbbbbbbbbbbba
abbbbbbbbbbbbbbbbbbbbbbbbbbbbbbbbbbbbbbbbbbbbbbbbbbbbbbbbbbbbbbbbbbbbbbbbbbbbbbbbbbbbbbbba
abbbbbbbbbbbbbbbbbbbbbbbbbbbbbbbbbbbbbbbbbbbbbbbbbbbbbbbbbbbbbbbbbbbbbbbbbbbbbbbbbbbbbbbba
abbbbbbbbbbbbbbbbbbbbbbbbbbbbbbbbbbbbbbbbbbbbbbbbbbbbbbbbbbbbbbbbbbbbbbbbbbbbbbbbbbbbbbbba
abbbbbbbbbbbbbbbbbbbbbbbbbbbbbbbbbbbbbbbbbbbbbbbbbbbbbbbbbbbbbbbbbbbbbbbbbbbbbbbbbbbbbbbba
abbbbbbbbbbbbbbbbbbbbbbbbbbbbbbbbbbbbbbbbbbbbbbbbbbbbbbbbbbbbbbbbbbbbbbbbbbbbbbbbbbbbbbbba
abbbbbbbbbbbbbbbbbbbbbbbbbbbbbbbbbbbbbbbbbbbbbbbbbbbbbbbbbbbbbbbbbbbbbbbbbbbbbbbbbbbbbbbba
abbbbbbbbbbbbbbbbbbbbbbbbbbbbbbbbbbbbbbbbbbbbbbbbbbbbbbbbbbbbbbbbbbbbbbbbbbbbbbbbbbbbbbbba
abbbbbbbbbbbbbbbbbbbbbbbbbbbbbbbbbbbbbbbbbbbbbbbbbbbbbbbbbbbbbbbbbbbbbbbbbbbbbbbbbbbbbbbba
abbbbbbbbbbbbbbbbbbbbbbbbbbbbbbbbbbbbbbbbbbbbbbbbbbbbbbbbbbbbbbbbbbbbbbbbbbbbbbbbbbbbbbbba
abbbbbbbbbbbbbbbbbbbbbbbbbbbbbbbbbbbbbbbbbbbbbbbbbbbbbbbbbbbbbbbbbbbbbbbbbbbbbbbbbbbbbbbba
abbbbbbbbbbbbbbbbbbbbbbbbbbbbbbbbbbbbbbbbbbbbbbbbbbbbbbbbbbbbbbbbbbbbbbbbbbbbbbbbbbbbbbbba
abbbbbbbbbbbbbbbbbbbbbbbbbbbbbbbbbbbbbbbbbbbbbbbbbbbbbbbbbbbbbbbbbbbbbbbbbbbbbbbbbbbbbbbba
abbbbbbbbbbbbbbbbbbbbbbbbbbbbbbbbbbbbbbbbbbbbbbbbbbbbbbbbbbbbbbbbbbbbbbbbbbbbbbbbbbbbbbbba
abbbbbbbbbbbbbbbbbbbbbbbbbbbbbbbbbbbbbbbbbbbbbbbbbbbbbbbbbbbbbbbbbbbbbbbbbbbbbbbbbbbbbbbba
abbbbbbbbbbbbbbbbbbbbbbbbbbbbbbbbbbbbbbbbbbbbbbbbbbbbbbbbbbbbbbbbbbbbbbbbbbbbbbbbbbbbbbbba
abbbbbbbbbbbbbbbbbbbbbbbbbbbbbbbbbbbbbbbbbbbbbbbbbbbbbbbbbbbbbbbbbbbbbbbbbbbbbbbbbbbbbbbba
abbbbbbbbbbbbbbbbbbbbbbbbbbbbbbbbbbbbbbbbbbbbbbbbbbbbbbbbbbbbbbbbbbbbbbbbbbbbbbbbbbbbbbbba
abbbbbbbbbbbbbbbbbbbbbbbbbbbbbbbbbbbbbbbbbbbbbbbbbbbbbbbbbbbbbbbbbbbbbbbbbbbbbbbbbbbbbbbba
abbbbbbbbbbbbbbbbbbbbbbbbbbbbbbbbbbbbbbbbbbbbbbbbbbbbbbbbbbbbbbbbbbbbbbbbbbbbbbbbbbbbbbbba
abbbbbbbbbbbbbbbbbbbbbbbbbbbbbbbbbbbbbbbbbbbbbbbbbbbbbbbbbbbbbbbbbbbbbbbbbbbbbbbbbbbbbbbba
abbbbbbbbbbbbbbbbbbbbbbbbbbbbbbbbbbbbbbbbbbbbbbbbbbbbbbbbbbbbbbbbbbbbbbbbbbbbbbbbbbbbbbbba
abbbbbbbbbbbbbbbbbbbbbbbbbbbbbbbbbbbbbbbbbbbbbbbbbbbbbbbbbbbbbbbbbbbbbbbbbbbbbbbbbbbbbbbba
abbbbbbbbbbbbbbbbbbbbbbbbbbbbbbbbbbbbbbbbbbbbbbbbbbbbbbbbbbbbbbbbbbbbbbbbbbbbbbbbbbbbbbbba
abbbbbbbbbbbbbbbbbbbbbbbbbbbbbbbbbbbbbbbbbbbbbbbbbbbbbbbbbbbbbbbbbbbbbbbbbbbbbbbbbbbbbbbba
abbbbbbbbbbbbbbbbbbbbbbbbbbbbbbbbbbbbbbbbbbbbbbbbbbbbbbbbbbbbbbbbbbbbbbbbbbbbbbbbbbbbbbbba
abbbbbbbbbbbbbbbbbbbbbbbbbbbbbbbbbbbbbbbbbbbbbbbbbbbbbbbbbbbbbbbbbbbbbbbbbbbbbbbbbbbbbbbba
abbbbbbbbbbbbbbbbbbbbbbbbbbbbbbbbbbbbbbbbbbbbbbbbbbbbbbbbbbbbbbbbbbbbbbbbbbbbbbbbbbbbbbbba
abbbbbbbbbbbbbbbbbbbbbbbbbbbbbbbbbbbbbbbbbbbbbbbbbbbbbbbbbbbbbbbbbbbbbbbbbbbbbbbbbbbbbbbba
abbbbbbbbbbbbbbbbbbbbbbbbbbbbbbbbbbbbbbbbbbbbbbbbbbbbbbbbbbbbbbbbbbbbbbbbbbbbbbbbbbbbbbbba
abbbbbbbbbbbbbbbbbbbbbbbbbbbbbbbbbbbbbbbbbbbbbbbbbbbbbbbbbbbbbbbbbbbbbbbbbbbbbbbbbbbbbbbba
abbbbbbbbbbbbbbbbbbbbbbbbbbbbbbbbbbbbbbbbbbbbbbbbbbbbbbbbbbbbbbbbbbbbbbbbbbbbbbbbbbbbbbbba
abbbbbbbbbbbbbbbbbbbbbbbbbbbbbbbbbbbbbbbbbbbbbbbbbbbbbbbbbbbbbbbbbbbbbbbbbbbbbbbbbbbbbbbba
abbbbbbbbbbbbbbbbbbbbbbbbbbbbbbbbbbbbbbbbbbbbbbbbbbbbbbbbbbbbbbbbbbbbbbbbbbbbbbbbbbbbbbbba
abbbbbbbbbbbbbbbbbbbbbbbbbbbbbbbbbbbbbbbbbbbbbbbbbbbbbbbbbbbbbbbbbbbbbbbbbbbbbbbbbbbbbbbba
abbbbbbbbbbbbbbbbbbbbbbbbbbbbbbbbbbbbbbbbbbbbbbbbbbbbbbbbbbbbbbbbbbbbbbbbbbbbbbbbbbbbbbbba
abbbbbbbbbbbbbbbbbbbbbbbbbbbbbbbbbbbbbbbbbbbbbbbbbbbbbbbbbbbbbbbbbbbbbbbbbbbbbbbbbbbbbbbba
abbbbbbbbbbbbbbbbbbbbbbbbbbbbbbbbbbbbbbbbbbbbbbbbbbbbbbbbbbbbbbbbbbbbbbbbbbbbbbbbbbbbbbbba
aaaaaaaaaaaaaaaaaaaaaaaaaaaaaaaaaaaaaaaaaaaaaaaaaaaaaaaaaaaaaaaaaaaaaaaaaaaaaaaaaaaaaaaaaa
"}

(1,1,2) = {"
cccccccccccccccccccccccccccccccccccccccccccccccccccccccccccccccccccccccccccccccccccccccccc
cddddddddddddddddddddddddddddddddddddddddddddddddddddddddddddddddddddddddddddddddddddddddc
cddddddddddddddddddddddddddddddddddddddddddddddddddddddddddddddddddddddddddddddddddddddddc
cddddddddddddddddddddddddddddddddddddddddddddddddddddddddddddddddddddddddddddddddddddddddc
cddddddddddddddddddddddddddddddddddddddddddddddddddddddddddddddddddddddddddddddddddddddddc
cddddddddddddddddddddddddddddddddddddddddddddddddddddddddddddddddddddddddddddddddddddddddc
cddddddddddddddddddddddddddddddddddddddddddddddddddddddddddddddddddddddddddddddddddddddddc
cddddddddddddddddddddddddddddddddddddddddddddddddddddddddddddddddddddddddddddddddddddddddc
cddddddddddddddddddddddddddddddddddddddddddddddddddddddddddddddddddddddddddddddddddddddddc
cddddddddddddddddddddddddddddddddddddddddddddddddddddddddddddddddddddddddddddddddddddddddc
cddddddddddddddddddddddddddddddddddddddddddddddddddddddddddddddddddddddddddddddddddddddddc
cddddddddddddddddddddddddddddddddddddddddddddddddddddddddddddddddddddddddddddddddddddddddc
cddddddddddddddddddddddddddddddddddddddddddddddddddddddddddddddddddddddddddddddddddddddddc
cddddddddddddddddddddddddddddddddddddddddddddddddddddddddddddddddddddddddddddddddddddddddc
cddddddddddddddddddddddddddddddddddddddddddddddddddddddddddddddddddddddddddddddddddddddddc
cddddddddddddddddddddddddddddddddddddddddddddddddddddddddddddddddddddddddddddddddddddddddc
cddddddddddddddddddddddddddddddddddddddddddddddddddddddddddddddddddddddddddddddddddddddddc
cddddddddddddddddddddddddddddddddddddddddddddddddddddddddddddddddddddddddddddddddddddddddc
cddddddddddddddddddddddddddddddddddddddddddddddddddddddddddddddddddddddddddddddddddddddddc
cddddddddddddddddddddddddddddddddddddddddddddddddddddddddddddddddddddddddddddddddddddddddc
cddddddddddddddddddddddddddddddddddddddddddddddddddddddddddddddddddddddddddddddddddddddddc
cddddddddddddddddddddddddddddddddddddddddddddddddddddddddddddddddddddddddddddddddddddddddc
cddddddddddddddddddddddddddddddddddddddddddddddddddddddddddddddddddddddddddddddddddddddddc
cddddddddddddddddddddddddddddddddddddddddddddddddddddddddddddddddddddddddddddddddddddddddc
cddddddddddddddddddddddddddddddddddddddddddddddddddddddddddddddddddddddddddddddddddddddddc
cddddddddddddddddddddddddddddddddddddddddddddddddddddddddddddddddddddddddddddddddddddddddc
cddddddddddddddddddddddddddddddddddddddddddddddddddddddddddddddddddddddddddddddddddddddddc
cddddddddddddddddddddddddddddddddddddddddddddddddddddddddddddddddddddddddddddddddddddddddc
cddddddddddddddddddddddddddddddddddddddddddddddddddddddddddddddddddddddddddddddddddddddddc
cddddddddddddddddddddddddddddddddddddddddddddddddddddddddddddddddddddddddddddddddddddddddc
cddddddddddddddddddddddddddddddddddddddddddddddddddddddddddddddddddddddddddddddddddddddddc
cddddddddddddddddddddddddddddddddddddddddddddddddddddddddddddddddddddddddddddddddddddddddc
cddddddddddddddddddddddddddddddddddddddddddddddddddddddddddddddddddddddddddddddddddddddddc
cddddddddddddddddddddddddddddddddddddddddddddddddddddddddddddddddddddddddddddddddddddddddc
cddddddddddddddddddddddddddddddddddddddddddddddddddddddddddddddddddddddddddddddddddddddddc
cddddddddddddddddddddddddddddddddddddddddddddddddddddddddddddddddddddddddddddddddddddddddc
cddddddddddddddddddddddddddddddddddddddddddddddddddddddddddddddddddddddddddddddddddddddddc
cddddddddddddddddddddddddddddddddddddddddddddddddddddddddddddddddddddddddddddddddddddddddc
cddddddddddddddddddddddddddddddddddddddddddddddddddddddddddddddddddddddddddddddddddddddddc
cddddddddddddddddddddddddddddddddddddddddddddddddddddddddddddddddddddddddddddddddddddddddc
cddddddddddddddddddddddddddddddddddddddddddddddddddddddddddddddddddddddddddddddddddddddddc
cddddddddddddddddddddddddddddddddddddddddddddddddddddddddddddddddddddddddddddddddddddddddc
cddddddddddddddddddddddddddddddddddddddddddddddddddddddddddddddddddddddddddddddddddddddddc
cddddddddddddddddddddddddddddddddddddddddddddddddddddddddddddddddddddddddddddddddddddddddc
cddddddddddddddddddddddddddddddddddddddddddddddddddddddddddddddddddddddddddddddddddddddddc
cddddddddddddddddddddddddddddddddddddddddddddddddddddddddddddddddddddddddddddddddddddddddc
cddddddddddddddddddddddddddddddddddddddddddddddddddddddddddddddddddddddddddddddddddddddddc
cddddddddddddddddddddddddddddddddddddddddddddddddddddddddddddddddddddddddddddddddddddddddc
cddddddddddddddddddddddddddddddddddddddddddddddddddddddddddddddddddddddddddddddddddddddddc
cddddddddddddddddddddddddddddddddddddddddddddddddddddddddddddddddddddddddddddddddddddddddc
cddddddddddddddddddddddddddddddddddddddddddddddddddddddddddddddddddddddddddddddddddddddddc
cddddddddddddddddddddddddddddddddddddddddddddddddddddddddddddddddddddddddddddddddddddddddc
cddddddddddddddddddddddddddddddddddddddddddddddddddddddddddddddddddddddddddddddddddddddddc
cddddddddddddddddddddddddddddddddddddddddddddddddddddddddddddddddddddddddddddddddddddddddc
cddddddddddddddddddddddddddddddddddddddddddddddddddddddddddddddddddddddddddddddddddddddddc
cddddddddddddddddddddddddddddddddddddddddddddddddddddddddddddddddddddddddddddddddddddddddc
cddddddddddddddddddddddddddddddddddddddddddddddddddddddddddddddddddddddddddddddddddddddddc
cddddddddddddddddddddddddddddddddddddddddddddddddddddddddddddddddddddddddddddddddddddddddc
cddddddddddddddddddddddddddddddddddddddddddddddddddddddddddddddddddddddddddddddddddddddddc
cddddddddddddddddddddddddddddddddddddddddddddddddddddddddddddddddddddddddddddddddddddddddc
cddddddddddddddddddddddddddddddddddddddddddddddddddddddddddddddddddddddddddddddddddddddddc
cddddddddddddddddddddddddddddddddddddddddddddddddddddddddddddddddddddddddddddddddddddddddc
cddddddddddddddddddddddddddddddddddddddddddddddddddddddddddddddddddddddddddddddddddddddddc
cddddddddddddddddddddddddddddddddddddddddddddddddddddddddddddddddddddddddddddddddddddddddc
cddddddddddddddddddddddddddddddddddddddddddddddddddddddddddddddddddddddddddddddddddddddddc
cddddddddddddddddddddddddddddddddddddddddddddddddddddddddddddddddddddddddddddddddddddddddc
cddddddddddddddddddddddddddddddddddddddddddddddddddddddddddddddddddddddddddddddddddddddddc
cddddddddddddddddddddddddddddddddddddddddddddddddddddddddddddddddddddddddddddddddddddddddc
cddddddddddddddddddddddddddddddddddddddddddddddddddddddddddddddddddddddddddddddddddddddddc
cddddddddddddddddddddddddddddddddddddddddddddddddddddddddddddddddddddddddddddddddddddddddc
cddddddddddddddddddddddddddddddddddddddddddddddddddddddddddddddddddddddddddddddddddddddddc
cddddddddddddddddddddddddddddddddddddddddddddddddddddddddddddddddddddddddddddddddddddddddc
cddddddddddddddddddddddddddddddddddddddddddddddddddddddddddddddddddddddddddddddddddddddddc
cddddddddddddddddddddddddddddddddddddddddddddddddddddddddddddddddddddddddddddddddddddddddc
cddddddddddddddddddddddddddddddddddddddddddddddddddddddddddddddddddddddddddddddddddddddddc
cddddddddddddddddddddddddddddddddddddddddddddddddddddddddddddddddddddddddddddddddddddddddc
cddddddddddddddddddddddddddddddddddddddddddddddddddddddddddddddddddddddddddddddddddddddddc
cddddddddddddddddddddddddddddddddddddddddddddddddddddddddddddddddddddddddddddddddddddddddc
cddddddddddddddddddddddddddddddddddddddddddddddddddddddddddddddddddddddddddddddddddddddddc
cddddddddddddddddddddddddddddddddddddddddddddddddddddddddddddddddddddddddddddddddddddddddc
cddddddddddddddddddddddddddddddddddddddddddddddddddddddddddddddddddddddddddddddddddddddddc
cddddddddddddddddddddddddddddddddddddddddddddddddddddddddddddddddddddddddddddddddddddddddc
cddddddddddddddddddddddddddddddddddddddddddddddddddddddddddddddddddddddddddddddddddddddddc
cddddddddddddddddddddddddddddddddddddddddddddddddddddddddddddddddddddddddddddddddddddddddc
cddddddddddddddddddddddddddddddddddddddddddddddddddddddddddddddddddddddddddddddddddddddddc
cddddddddddddddddddddddddddddddddddddddddddddddddddddddddddddddddddddddddddddddddddddddddc
cddddddddddddddddddddddddddddddddddddddddddddddddddddddddddddddddddddddddddddddddddddddddc
cddddddddddddddddddddddddddddddddddddddddddddddddddddddddddddddddddddddddddddddddddddddddc
cddddddddddddddddddddddddddddddddddddddddddddddddddddddddddddddddddddddddddddddddddddddddc
cccccccccccccccccccccccccccccccccccccccccccccccccccccccccccccccccccccccccccccccccccccccccc
"}
